+-+-+-+-+-+-+-+-+-+-+-+-+-+-+-+-+-+-+-+-+-+-+-+-+-+-+-+
→→→→→→→→→→→→|   |       |↑→→→→|↑→→→→→→|       |   |   |
+-+-+-+-+-+↓+-+ + +-+-+ +↑+-+↓+↑+-+ +↓+ +-+-+ + + +-+ +
|←←←←↑|    ↓|   | |     |↑|←←↓|↑| | |↓|   |     |     |
+↓+ +↑+-+-+↓+ +-+ + +-+-+↑+↓+-+↑+ + +↓+-+-+ +-+-+ + +-+
|↓| |↑|←←←←↓|   | | |   |↑|↓|↑→→|   |↓→→→→  |     |   |
+↓+-+↑+↓+-+-+-+ + + +-+ +↑+↓+↑+-+-+-+-+-+↓+-+ +-+-+ +-+
|↓|↑→→|↓→→|     | |   | |↑|↓|↑|  ←←←←←←←←↓|   |   |   |
+↓+↑+-+ +↓+-+ + + +-+ + +↑+↓+↑+ +↓+-+-+-+-+ +-+-+ +-+-+
|↓|←←↑| |↓|   | | |   | |↑|↓→→| |↓|   |           |   |
+↓+-+↑+-+↓+ +-+ +-+ +-+ +↑+-+-+ +↓+ +-+ +-+ +-+-+-+ +-+
|↓→→|←←←←↓|   |    ↑→→→→|↑|     |↓|     | | |   | |   |
+-+↓+-+-+-+-+ +-+-+↑+-+↓+↑+ +-+-+↓+-+-+-+ + + + + + +-+
|  ↓→→→→→→→→| |↑→→|←←↑|↓→→|   |←←↓|↑→→|   |   | | |   |
+ +-+-+ +-+↓+ +↑+↓+-+↑+-+-+-+ +↓+-+↑+↓+ +-+-+ + + +-+ +
| | |     |↓|↑→→|↓|↑→→|       |↓|↑→→|↓|       |   |   |
+ + + +-+ +↓+↑+-+↓+↑+-+-+-+-+-+↓+↑+ +↓+-+-+-+-+-+-+-+-+
| | | |   |↓|↑| |↓→→    |     |↓|↑| |↓→→→→→→|     |   |
+ + + + +-+↓+↑+ +-+ +-+ + +-+ +↓+↑+-+-+-+-+↓+ +-+ + +-+
|   | |   |↓→→|   | |   |   | |↓→→|     |  ↓→→→→| |   |
+-+-+ +-+ +-+-+-+ +-+ +-+-+-+ +-+-+ +-+ + +-+ +↓+-+-+ +
|   |   | |     |     |     | |   |   | |   | |↓→→|   |
+ + +-+-+ + +-+ +-+ +-+-+-+ + +-+ +-+-+ +-+ + +-+↓+-+-+
|         |   |     |   |     |     |   |     |  ↓→→→→→
+-+-+-+-+-+-+-+-+-+-+-+-+-+-+-+-+-+-+-+-+-+-+-+-+-+-+-+
