+-+-+-+-+-+-+-+-+-+-+-+-+-+-+-+-+-+-+-+-+-+-+-+-+-+
→→→→→→→→→→→→|   |       |     |       |       |   |
+-+-+-+-+-+↓+-+ + +-+-+ + +-+ + +-+ + + +-+-+ + + +
|←←←←↑|    ↓|   | |     | |   | | | | |   |     | |
+↓+ +↑+-+-+↓+ +-+ + +-+-+ + +-+ + + + +-+-+ +-+-+ +
|↓| |↑|←←←←↓|   | | |   | | |   |   |   |   |     |
+↓+-+↑+↓+-+-+-+ + + +-+ + + + +-+-+-+-+-+ +-+ +-+-+
|↓|↑→→|↓→→|   | | |   | | | | |           |   |   |
+↓+↑+-+ +↓+-+ + + +-+ + + + + + + +-+-+-+-+ +-+-+ +
|↓|←←↑| |↓|   | | |   | | |   | | |   |           |
+↓+-+↑+-+↓+ +-+ +-+ +-+ + +-+-+ + + +-+ +-+ +-+-+-+
|↓→→|←←←←↓|   |         | |     | |     | | |   | |
+-+↓+-+-+-+-+ +-+-+ +-+ + + +-+-+ +-+-+-+ + + + + +
|  ↓→→→→    | |   |   |   |   |   |   |   |   | | |
+ +-+-+↓+-+ + + + +-+ +-+-+-+ + +-+ + + +-+-+ + + +
| | |  ↓→→| |   | |   |       | |   | |       |   |
+ + + +-+↓+ + +-+ + +-+-+-+-+-+ + + + +-+-+-+-+-+-+
| | | |←←↓| | | |       |     | | | |       |     |
+ + + +↓+-+ + + +-+ +-+ + +-+ + + +-+-+-+-+ + +-+ +
|   | |↓→→|   |   | |   |   | |   |     |       | |
+-+-+ +-+↓+-+-+-+ +-+ +-+-+-+ +-+-+ +-+ + +-+ + +-+
|←←↑|   |↓|     |     |     | |   |   | |   | |   |
+↓+↑+-+-+↓+ +-+ +-+ +-+-+-+ + +-+ +-+-+ +-+ + +-+ +
|↓|←←↑|←←↓| |   |   |           | |         |   | |
+↓+-+↑+↓+-+ + +-+ +-+ +-+-+-+ + + + +-+-+-+-+ + +-+
|↓|↑→→|↓| | |     |     |     |   | |   |     |   |
+↓+↑+-+↓+ + +-+-+-+ +-+-+ + +-+-+-+ +-+ + +-+-+-+ +
|↓|←←←←↓|   |↑→→  | |   | | |     |     |   |   | |
+↓+-+-+-+-+-+↑+↓+-+ + + + +-+ +-+ + +-+-+-+-+ + + +
|↓|↑→→→→|   |↑|↓|   | | | |   |   |     |     |   |
+↓+↑+-+↓+ + +↑+↓+ +-+-+ + + +-+ +-+-+-+-+ +-+-+ +-+
|↓→→|←←↓| | |↑|↓|↑→→→→| |   |   |         | |     |
+-+-+↓+ + + +↑+↓+↑+-+↓+ +-+-+ +-+ +-+-+-+-+ + +-+-+
|   |↓| | | |↑|↓→→|←←↓| |   | |   |   |   | | |   |
+ + +↓+ + + +↑+-+ +↓+-+ + + + + +-+ + + + + + + + +
| | |↓| | | |←←↑| |↓→→| | |   | |   |   |   |   | |
+ +-+↓+ +-+ +-+↑+-+-+↓+ +-+-+-+ + +-+ +-+-+ +-+-+ +
| |  ↓|   | | |↑|   |↓|     |   |   |     | |     |
+ + +↓+-+ + + +↑+ + +↓+-+ + + +-+-+ +-+-+ +-+ +-+-+
|   |↓→→|   |↑→→| |  ↓    | | |     |       |   | |
+-+-+-+↓+-+-+↑+-+ +-+↓+-+-+ + + +-+-+-+-+ + + + + +
|     |↓→→→→→→|   |←←↓|     | |     |     |   | | |
+ +-+ +-+-+-+-+ +-+↓+-+-+-+-+ + +-+ + +-+-+-+-+ + +
|   |   |       |←←↓|       | | |   |         |   |
+-+ +-+ + +-+-+-+↓+-+ +-+-+ + + + +-+-+-+-+-+ +-+ +
|     | | |←←←←←←↓|   |   |   | |   |     |   |   |
+ + + +-+ +↓+-+-+-+ +-+ + +-+-+-+-+ + +-+ + +-+-+ +
| | |     |↓|       | | |   |   | | |   |   |   | |
+-+-+-+-+-+↓+ +-+-+ + + + +-+ + + + +-+ +-+-+ + + +
|         |↓  |     |   |     |     |   |     |   |
+-+-+-+-+-+↓+-+-+-+-+-+-+-+-+-+-+-+-+-+-+-+-+-+-+-+
