+-+-+-+-+-+-+-+-+-+-+-+-+-+-+-+-+-+-+-+-+-+-+-+-+-+
→→→→→→→→→→→→|   |       |     |       |       |   |
+-+-+-+-+-+↓+-+ + +-+-+ + +-+ + +-+ + + +-+-+ + + +
|←←←←↑|    ↓|   | |     | |   | | | | |   |     | |
+↓+ +↑+-+-+↓+ +-+ + +-+-+ + +-+ + + + +-+-+ +-+-+ +
|↓| |↑|←←←←↓|   | | |   | | |   |   |   |   |     |
+↓+-+↑+↓+-+-+-+ + + +-+ + + + +-+-+-+-+-+ +-+ +-+-+
|↓|↑→→|↓→→|   | | |   | | | | |           |   |   |
+↓+↑+-+ +↓+-+ + + +-+ + + + + + + +-+-+-+-+ +-+-+ +
|↓|←←↑| |↓|   | | |   | | |   | | |   |           |
+↓+-+↑+-+↓+ +-+ +-+ +-+ + +-+-+ + + +-+ +-+ +-+-+-+
|↓→→|←←←←↓|   |         | |     | |     | | |   | |
+-+↓+-+-+-+-+ +-+-+ +-+ + + +-+-+ +-+-+-+ + + + + +
|  ↓→→→→    | |   |   |   |   |   |   |   |   | | |
+ +-+-+↓+-+ + + + +-+ +-+-+-+ + +-+ + + +-+-+ + + +
| | |  ↓→→| |   | |   |       | |   | |       |   |
+ + + +-+↓+ + +-+ + +-+-+-+-+-+ + + + +-+-+-+-+-+-+
| | | |←←↓| | | |       |     | | | |       |     |
+ + + +↓+-+ + + +-+ +-+ + +-+ + + +-+-+-+-+ + +-+ +
|   | |↓→→|   |   | |   |   | |   |     |       | |
+-+-+ +-+↓+-+-+-+ +-+ +-+-+-+ +-+-+ +-+ + +-+ + +-+
|←←↑|   |↓|     |     |     | |   |   | |   | |   |
+↓+↑+-+-+↓+ +-+ +-+ +-+-+-+ + +-+ +-+-+ +-+ + +-+ +
|↓|←←↑|←←↓| |   |   |           | |↑→→→→→→→→→→→→| |
+↓+-+↑+↓+-+ + +-+ +-+ +-+-+-+ + + +↑+-+-+-+-+ +↓+-+
|↓|↑→→|↓| | |     |     |     |   |↑|   |     |↓→→|
+↓+↑+-+↓+ + +-+-+-+ +-+-+ + +-+-+-+↑+-+ + +-+-+-+↓+
|↓|←←←←↓|   |↑→→  | |   | | |     |↑    |   |   |↓|
+↓+-+-+-+-+-+↑+↓+-+ + + + +-+ +-+ +↑+-+-+-+-+ + +↓+
|↓|↑→→→→|   |↑|↓|   | | | |   |   |↑    |     |←←↓|
+↓+↑+-+↓+ + +↑+↓+ +-+-+ + + +-+ +-+↑+-+-+ +-+-+↓+-+
|↓→→|←←↓| | |↑|↓|↑→→→→| |   |   |↑→→|     | |←←↓  |
+-+-+↓+ + + +↑+↓+↑+-+↓+ +-+-+ +-+↑+-+-+-+-+ +↓+-+-+
|   |↓| | | |↑|↓→→|←←↓| |   | |↑→→|   |   | |↓|↑→→|
+ + +↓+ + + +↑+-+ +↓+-+ + + + +↑+-+ + + + + +↓+↑+↓+
| | |↓| | | |←←↑| |↓→→| | |   |↑|   |   |   |↓→→|↓|
+ +-+↓+ +-+ +-+↑+-+-+↓+ +-+-+-+↑+ +-+ +-+-+ +-+-+↓+
| |  ↓|   | | |↑|   |↓|     |↑→→|   |     | |←←←←↓|
+ + +↓+-+ + + +↑+ + +↓+-+ + +↑+-+-+ +-+-+ +-+↓+-+-+
|   |↓→→|   |↑→→| |  ↓    | |↑|     |       |↓→→| |
+-+-+-+↓+-+-+↑+-+ +-+↓+-+-+ +↑+ +-+-+-+-+ + + +↓+ +
|     |↓→→→→→→|   |←←↓|     |↑|     |     |   |↓| |
+ +-+ +-+-+-+-+ +-+↓+-+-+-+-+↑+ +-+ + +-+-+-+-+↓+ +
|   |   |       |←←↓|↑→→→→→→|↑| |   |         |↓→→|
+-+ +-+ + +-+-+-+↓+-+↑+-+-+↓+↑+ + +-+-+-+-+-+ +-+↓+
|     | | |←←←←←←↓|↑→→|   |↓→→| |   |     |   |  ↓|
+ + + +-+ +↓+-+-+-+↑+-+ + +-+-+-+-+ + +-+ + +-+-+↓+
| | |     |↓|↑→→→→→→| | |   |   | | |   |   |   |↓|
+ +-+-+-+-+↓+↑+-+-+ + + + +-+ + + + +-+ +-+-+ + +↓+
|         |↓→→|     |   |     |     |   |     |  ↓→
+-+-+-+-+-+-+-+-+-+-+-+-+-+-+-+-+-+-+-+-+-+-+-+-+-+
