+-+-+-+-+-+-+-+-+-+-+-+-+-+-+-+-+-+-+-+-+-+-+-+-+-+
→→→→→→→→→→→→|   |       |↑→→→→|↑→→→→→→|       |   |
+-+-+-+-+-+↓+-+ + +-+-+ +↑+-+↓+↑+-+ +↓+ +-+-+ + + +
|←←←←↑|    ↓|   | |     |↑|←←↓|↑| | |↓|   |     | |
+↓+ +↑+-+-+↓+ +-+ + +-+-+↑+↓+-+↑+ + +↓+-+-+ +-+-+ +
|↓| |↑|←←←←↓|   | | |   |↑|↓|↑→→|   |↓→→→→  |     |
+↓+-+↑+↓+-+-+-+ + + +-+ +↑+↓+↑+-+-+-+-+-+↓+-+ +-+-+
|↓|↑→→|↓→→|     | |   | |↑|↓|↑|  ←←←←←←←←↓|   |   |
+↓+↑+-+ +↓+-+ + + +-+ + +↑+↓+↑+ +↓+-+-+-+-+ +-+-+ +
|↓|←←↑| |↓|   | | |   | |↑|↓→→| |↓|   |           |
+↓+-+↑+-+↓+ +-+ +-+ +-+ +↑+-+-+ +↓+ +-+ +-+ +-+-+-+
|↓→→|←←←←↓|   |    ↑→→→→|↑|     |↓|     | | |   | |
+-+↓+-+-+-+-+ +-+-+↑+-+↓+↑+ +-+-+↓+-+-+-+ + + + + +
|  ↓→→→→→→→→| |↑→→|←←↑|↓→→|   |←←↓|↑→→|   |   | | |
+ +-+-+ +-+↓+ +↑+↓+-+↑+-+-+-+ +↓+-+↑+↓+ +-+-+ + + +
| | |     |↓|↑→→|↓|↑→→|       |↓|↑→→|↓|       |   |
+ + + +-+ +↓+↑+-+↓+↑+-+-+-+-+-+↓+↑+ +↓+-+-+-+-+-+-+
| | | |   |↓|↑| |↓→→    |     |↓|↑| |↓→→→→→→|     |
+ + + + +-+↓+↑+ +-+ +-+ + +-+ +↓+↑+-+-+-+-+↓+ +-+ +
|   | |   |↓→→|   | |   |   | |↓→→|     |  ↓→→→→| |
+-+-+ +-+ +-+-+-+ +-+ +-+-+-+ +-+-+ +-+ + +-+ +↓+-+
|   |   | |     |     |     | |   |   | |   | |↓→→|
+ + +-+-+ + +-+ +-+ +-+-+-+ + +-+ +-+-+ +-+ + +-+↓+
|         |   |     |   |     |     |   |     |  ↓→
+-+-+-+-+-+-+-+-+-+-+-+-+-+-+-+-+-+-+-+-+-+-+-+-+-+
